11111111111111111111111111111111111111111
10000000000000001110000001110000000000001
10000000000000001110000001110000000000001
10000000000000001110000001110000000000001
10000000002220002220002220002220000000001
10000000002220002220002220002220000000001
10000000002220002220002220002220000000001
10000000002220002220002220002220000000001
10000000002220002220002220002220000000001
10000000002220002220002220002220000000001
10002222222220002222222222222222222220001
10002222222220002222222222222222222220001
10002222222220002222222222222222222220001
11110000000000000000000000000000000001111
11110000000000000000000000000000000001111
11110000000000000000000000000000000001111
10002222222222221110002220002222222220001
10002222222222221110002220002222222220001
10002222222222221110002220002222222220001
10000000000000000000002220002220000000001
10000000000000000000002220002220000000001
10000000000000000000002220002220000000001
10002222222220002220002220002222222220001
10002222222220002220002220002222222220001
10002222222220002220002220002222222220001
11110000002220000000002220002220000001111
11110000002220000000002220002220000001111
11110000002220000000002220002220000001111
10002222222220002220002220002222222220001
10002222222220002220002220002222222220001
10002222222220002220002220002222222220001
10000000002220002220000000000000000000001
10000000002220002220000000000000000000001
10000000002220002220000000000000000000001
10002222222220002220002222222222222220001
10002222222220002220002222222222222220001
10002222222220002220002222222222222220001
10000000002220002220002220002220000000001
10000000002220002220002220002220000000001
10000000002220002220002220002220000000001
10000000002220002220002220002220000000001
10000000002220002220002220002220000000001
10000000002220002220002220002220000000001
11111111111111111111111111111111111111111
